{
  "name": "Iris Rev. 7",
  "vendorProductId": 3406852694,
  "macros": [],
  "layers": [
    [
      "KC_ESC",
      "KC_1",
      "KC_2",
      "KC_3",
      "KC_4",
      "KC_5",
      "KC_TAB",
      "KC_Q",
      "KC_W",
      "KC_E",
      "KC_R",
      "KC_T",
      "KC_LSFT",
      "KC_A",
      "KC_S",
      "KC_D",
      "KC_F",
      "KC_G",
      "KC_LCTL",
      "KC_Z",
      "KC_X",
      "KC_C",
      "KC_V",
      "KC_B",
      "KC_NO",
      "KC_NO",
      "KC_LALT",
      "KC_LGUI",
      "FN_MO13",
      "FN_MO13",
      "KC_BSPC",
      "KC_0",
      "KC_9",
      "KC_8",
      "KC_7",
      "KC_6",
      "KC_BSLS",
      "KC_P",
      "KC_O",
      "KC_I",
      "KC_U",
      "KC_Y",
      "KC_SFTENT",
      "KC_SCLN",
      "KC_L",
      "KC_K",
      "KC_J",
      "KC_H",
      "KC_RCTL",
      "KC_SLSH",
      "KC_DOT",
      "KC_COMM",
      "KC_M",
      "KC_N",
      "KC_NO",
      "KC_NO",
      "KC_RALT",
      "FN_MO23",
      "KC_SPC",
      "KC_SPC"
    ],
    [
      "S(KC_GRV)",
      "KC_TRNS",
      "KC_TRNS",
      "KC_TRNS",
      "KC_TRNS",
      "KC_TRNS",
      "RESET",
      "KC_TRNS",
      "KC_TRNS",
      "KC_TRNS",
      "KC_TRNS",
      "KC_TRNS",
      "KC_LSFT",
      "KC_TRNS",
      "KC_TRNS",
      "KC_TRNS",
      "KC_TRNS",
      "KC_TRNS",
      "KC_LCTL",
      "KC_TRNS",
      "KC_TRNS",
      "KC_TRNS",
      "KC_TRNS",
      "KC_TRNS",
      "KC_NO",
      "KC_NO",
      "KC_TRNS",
      "KC_LGUI",
      "KC_TRNS",
      "KC_TRNS",
      "KC_DEL",
      "KC_TRNS",
      "KC_TRNS",
      "S(KC_0)",
      "S(KC_RBRC)",
      "KC_RBRC",
      "KC_TRNS",
      "KC_TRNS",
      "KC_TRNS",
      "S(KC_9)",
      "S(KC_LBRC)",
      "KC_LBRC",
      "KC_SFTENT",
      "KC_TRNS",
      "KC_RGHT",
      "KC_UP",
      "KC_DOWN",
      "KC_LEFT",
      "KC_RCTL",
      "KC_TRNS",
      "KC_TRNS",
      "KC_TRNS",
      "S(KC_SCLN)",
      "KC_SCLN",
      "KC_NO",
      "KC_NO",
      "KC_LALT",
      "KC_TRNS",
      "A(KC_E)",
      "A(KC_E)"
    ],
    [
      "KC_F12",
      "KC_F1",
      "KC_F2",
      "KC_F3",
      "KC_F4",
      "KC_F5",
      "KC_TRNS",
      "KC_BRIU",
      "KC_VOLU",
      "S(KC_COMM)",
      "S(KC_DOT)",
      "KC_QUOT",
      "KC_LSFT",
      "KC_BRID",
      "KC_VOLD",
      "KC_EQL",
      "KC_MINS",
      "S(KC_QUOT)",
      "KC_LCTL",
      "KC_TRNS",
      "KC_TRNS",
      "S(KC_EQL)",
      "S(KC_MINS)",
      "KC_GRV",
      "KC_NO",
      "KC_NO",
      "KC_LALT",
      "KC_LGUI",
      "KC_SPC",
      "KC_SPC",
      "KC_F11",
      "KC_F10",
      "KC_F9",
      "KC_F8",
      "KC_F7",
      "KC_F6",
      "RESET",
      "RGB_MOD",
      "RGB_VAI",
      "RGB_SAI",
      "RGB_HUI",
      "RGB_TOG",
      "KC_SFTENT",
      "RGB_RMOD",
      "RGB_VAD",
      "RGB_SAD",
      "RGB_HUD",
      "KC_TRNS",
      "KC_RCTL",
      "KC_TRNS",
      "KC_TRNS",
      "KC_TRNS",
      "KC_TRNS",
      "KC_TRNS",
      "KC_NO",
      "KC_NO",
      "KC_TRNS",
      "KC_TRNS",
      "KC_TRNS",
      "KC_TRNS"
    ],
    [
      "KC_TRNS",
      "KC_TRNS",
      "KC_TRNS",
      "KC_TRNS",
      "KC_TRNS",
      "KC_TRNS",
      "KC_TRNS",
      "KC_TRNS",
      "KC_TRNS",
      "KC_TRNS",
      "KC_TRNS",
      "KC_TRNS",
      "KC_TRNS",
      "KC_TRNS",
      "KC_TRNS",
      "KC_TRNS",
      "KC_TRNS",
      "KC_TRNS",
      "KC_TRNS",
      "KC_TRNS",
      "KC_TRNS",
      "KC_TRNS",
      "KC_TRNS",
      "KC_TRNS",
      "KC_NO",
      "KC_NO",
      "KC_TRNS",
      "KC_TRNS",
      "KC_TRNS",
      "KC_TRNS",
      "KC_TRNS",
      "KC_TRNS",
      "KC_TRNS",
      "KC_TRNS",
      "KC_TRNS",
      "KC_TRNS",
      "KC_TRNS",
      "KC_TRNS",
      "KC_TRNS",
      "KC_TRNS",
      "KC_TRNS",
      "KC_TRNS",
      "KC_TRNS",
      "KC_TRNS",
      "KC_TRNS",
      "KC_TRNS",
      "KC_TRNS",
      "KC_TRNS",
      "KC_TRNS",
      "KC_TRNS",
      "KC_TRNS",
      "KC_TRNS",
      "KC_TRNS",
      "KC_TRNS",
      "KC_NO",
      "KC_NO",
      "KC_TRNS",
      "KC_TRNS",
      "KC_TRNS",
      "KC_TRNS"
    ]
  ]
}
